111111111111111111111111111111111111111
10000000000000000000000000000000000C111
1000001100111111111100000001111111001C1
100011C1C0100000111100C0000000000011101
10010001110001001P100000000000001010001
10011101C000110010111100000001101010001
1000000111110001E00001111100001C1000001
10C000000000000100000000000000111000001
111111111111111111111111111111111111111