1111111111111111111111111111111111111111111111111111111111
10000011000000000000000000000000000000000000000000000000P1
1000000000000110000000000000000000000000000000000000000001
1E000C0000000000000000000000000000000000000000000000000001
1000000011000000000000000000000000000000000000000000000001
1000000000000000000000000000000000000000000000000000000001
10C0011110000000000000000000000010000000000000000000000001
1000000000000000000000000000000000000000000000000000000001
1000000000000000000000000000000000000000000000000000000001
1000000000000000011111100000000000000000000000000000000001
1000000000000000000010C00000000000000000000000000000000001
1000000000000000000010001111111100000000000000000000000001
1000000000000000000000000000000000000000000000000000000001
1000000000000000000000000000000000000000000000000000000001
1000000000000000000000000000000000000000000000000000000001
1000000000000000000000000000000000000000000000000000000001
1000000000000000000000011111000000000000000000000000000001
1000000000000000001111100000000000000000000000000000000001
1000000000000000000000000000000000000000000000000000000001
1000000000000000000000000000000000000000000000000000000001
1000000000000000000000000000000000000000000000000000000001
1000000000000000000000000000000000000000000000000000000001
10000000000000000000000000000000000C0000000000000000000001
1000000000000000000000000000000000000000000000000000000001
1000000000000000000000000000000000000000000000000000000001
1000000000000000000000000000000000000000000000000000000001
1000000000000000000000000000000000000000000000000000000001
1000000000000000000000000000000000000000000000000000000001
1000000000000000000000000000000000000000000000000000000001
1000000000000111110000000000000000000000000000000000000001
1000000000000000000000000000000000000000000000000000000001
1000000000000000000000000000000000000000000000000000000001
1111111111111111111111111111111111111111111111111111111111

