1111111111
1P10000001
1110000C01
1000000001
10000C0001
1000000001
1111111111