1111111111
1P00000001
1000000C01
1000000001
10000C0001
1000000001
1111111111