1111111111
1P00000001
1000000C01
1000000001
10000C0111
10000001E1
1111111111